高风险漏洞列表		
漏洞名称	漏洞级别	检测类型             HRisk 0xC0000000
程序反编译	高	应用自身
动态调试检测	高	应用自身
SO注入检测	高	应用自身
Activity劫持	高	应用自身安全
Janus漏洞	高	应用自身安全
WebView远程代码执行	高	应用自身安全
XSS漏洞	高	服务端安全
后门木马检测	高	服务端安全
键盘劫持	高	应用自身




-------------------------------------------------------
中风险漏洞列表		
漏洞名称	漏洞级别	检测类型             MRisk 0x80000000 
调试日志函数调用风险	中	应用自身         MRisk + 1 
日志泄露风险	中	应用自身                 MRisk + 2 
存储卡的操作行为	中	应用自身             MRisk + 3 
残留URL检测	中	应用自身                     MRisk + 4 ?????????
获取地理位置行为	中	应用自身             MRisk + 5 
设备信息手机号操作行为	中	应用自身         MRisk + 6 
动态注册Receiver风险	中	应用自身         MRisk + 7 
AES/DES弱加密	中	应用自身                 MRisk + 8 ===
升级包数据篡改风险	中	应用自身             MRisk + 9 
SharedPreferences任意读写	中	应用自身     MRisk + A 
传输协议分析	中	应用自身                 MRisk + B 
主机名弱校验风险	中	应用自身             MRisk + C 
Zip文件目录遍历风险	中	应用自身             MRisk + D 
初始化IvParameterSpec函数错误	中	应用自身 MRisk + E 
Service配置安全	中	应用自身                 MRisk + F 
ContentProvider配置安全	中	应用自身         MRisk + 10 
残留帐号密码检测	中	应用自身             MRisk + 11
Intent隐式调用	中	应用自身                 MRisk + 12
PendingIntent错误使用Intent风险	中	应用自身 MRisk + 13
BroadcastReceiver配置安全	中	应用自身     MRisk + 14
WebView file域同源策略绕过风险	中	应用自身 MRisk + 15
服务端证书校验	中	应用自身                 MRisk + 16
客户端证书校验	中	应用自身                 MRisk + 17
数据备份配置风险	中	应用自身安全         MRisk + 18
代码混淆安全	中	应用自身安全             MRisk + 19
Activity配置安全	中	应用自身安全         MRisk + 1A
二次打包攻击	中	应用自身安全             MRisk + 1B
服务器端Banner泄漏	中	应用自身安全         MRisk + 1C
请求数据远程传输保密性	中	应用自身安全     MRisk + 1D
配置文件敏感信息检测	中	数据通信安全     MRisk + 1E
服务器端口检测	中	应用自身安全             MRisk + 1F
通信协议安全	中	应用自身安全             MRisk + 20
通信套接字安全	中	应用自身安全             MRisk + 21
程序反编译	中	应用自身安全                 MRisk + 22
数据库敏感信息检测	中	应用自身安全         MRisk + 23
不安全接口检测	中	应用自身安全             MRisk + 24
篡改和二次打包漏洞	中	应用自身安全         MRisk + 25




----------------------------------------------------------------

低风险漏洞列表		
漏洞名称	漏洞级别	检测类型                  LRisk 0x40000000 
使用反射检测	低	应用自身安全
Intent Scheme URL攻击漏洞	低	应用自身安全
广告插入风险	低	应用自身安全
敏感函数调用	低	应用自身安全
加密函数检测	低	应用自身安全
HTTP网络请求列表	低	服务端安全
不安全的HTTP方法	低	服务端安全
服务器端口检测	低	服务端安全
应用权限安全	低	应用自身安全
动态加载DEX文件检测	低	应用自身安全
root环境防护检测	低	应用自身安全
纯java代码风险	低	应用自身安全
资源文件明文保存风险	低	应用自身安全
本地验证码生成风险	低	业务操作安全
随机数生成函数使用错误	低	应用自身安全
ContentProvider访问路径配置安全	低	应用自身安全
代码混淆安全	低	应用自身安全
残留Email检测	低	应用自身安全
残留URL检测	低	应用自身安全
残留手机号检测	低	应用自身安全
Webview隐藏接口风险	低	应用自身安全
模拟器环境防护检测	低	服务端安全












